vv00000000000000000vv
vv00000000000000000vv
000vvvvvvvvvvvvvvv000
000vvvv0000000vvvv000
000vvv000000000vvv000
000vv00000000000vv000
00v000000000000000v00
000vv00000000000vv000
000vvv000000000vvv000
000vvvv0000000vvvv000
000vvvvvvvvvvvvvvv000
vv00000000000000000vv
vv00000000000000000vv