ccccccccc
+'1'csAsc
ccc+c+cAc
cs+'''+sc
ccc'''ccc
cs+'''+sc
cCc+c+cBc
csCscsBsc
ccccccccc