000000000000
00000//00000
0000////0000
000//00//000
00///00///0/
0//00//00000
0//00//00000
00///00///0/
000//00//000
0000////0000
00000//00000
000000000000