000000U00UUUUU0000_0000U0000000U00
0000UU00UU000U0000_00000000U000000
000U00000UU00U0000_0000U0000000000
00UU00UU000U0U0000_0000000UUUUU000
00UU0000000000000_000000UU0UUUU000
00000000000000|00_00000UU0UUU0U000
000U00000000||0||_0000U00U0U0UUUUU
0000000000||0000__|0000000U00UU0UU
00000000||00____0_0||0000U000U0U00
000000||_0__00_00__00||0000000U000
0000||__U__000_00_0__0_||000000000
000|__0UU_0_0UU___000_0__||0000000
00||_000__0__U000_0UU000___||00000
00__0000_0000__0__0U00__000__||000
___0000_0000__0_0_00__U__000U_|0__
00|__0__00__0000w_w00000_00U0___00
00|_0__0__0000ww:0:ww000U__0__|000
00|_000__000ww::/_/::ww000__0_|000
00|_0w00___w:://___//::w__0U0_|000
00|_00__00w0_/__0_0__/_0w000___|00
00|_0_0000w:/__00_00__/:w0__00_|00
00|___0000w:/_0_000_0_/:w0_00U_|00
00|0_UU000w:/_0000000_/:w0_00U_|00
00|0_UU000w:/___000___/:w0U__0_|00
00|0___000w:___00_00___:w0000_||00
00|_00_000_0://_____//:0_0000_|000
00|_0w0___0ww:://_//::ww0__0__|000
00|_00__U_000ww::_::ww000_0__|0000
00|___000__0000ww0ww00UU0_00___000
00___000U00__0U00_000000__00_|_000
__0||__00U00_00U0_0000__0__0_|0___
00000||____0_0000_000_00000__|0000
0000000||||_|__00_000_0U00__||0000
00000000000|0||___________||000000
000U00U00000000|||_|||||||00000000
UU00U0000000000000_0000000U0000000
00000U00U0000000000000U0U000000000
00000U00U00000000000UUUUUUU0000000