000000U00UUUUU0000_0000U0000000U00
0000UU00UU000U0000_00000000U000000
000U00000UU00U0000_0000U0000000000
00UU00UU000U0U000__0000000UUUUU000
00UU0000000000000_000000UU0UUUU000
00000000000000000_00000UU0UUU0U000
000U0000000||||||_0000U00U0U0UUUUU
000000000|||000___||000000U00UU0UU
0000000|||0_____0_0|||000U000U0U00
00000|||____00_00___0|||000000U000
000|||__U___00__0_0____|||00000000
000|___UU_0_0UU___0000___|||000000
00||_000__0__U000_0UU00____|||0000
00___00__000______0U0___00___||000
____000_0000__000_00__U__000U_|___
00|_____00___000w_w00000__0U0___00
00|_0__0___000ww:0:ww000U__0__|000
00|_00___000ww::/_/::ww000____|000
00|_0w00___w::///_///::w___U0_||00
00|_0____0w0_//_0_0_//_0w000___|00
00|_0_0000w:/__00_00__/:w0___0_|00
00|___0000w:/___000___/:w0_00U_|00
00|0_UU000w:/_0000000_/:w0__0U_|00
00|0_UU000w:/___000___/:w0U____|00
00|____000w:____0_0____:w0000_||00
00|_00_00__0:///___///:0__000_|000
00|_0w____0ww:://_//::ww0_____|000
00|_00__U_000ww::_::ww000_0__||000
00|____00___000ww0ww00UU0_00___000
00____00U00__0U00_00000___00_|_000
___||___0U00_00U0_000___0__0_|____
0000|||_______000_000_0000___|0000
000000|||||||___0_000_0U0___||0000
000000000000|||___________|||00000
000U00U0000000||||_||||||||0000000
UU00U0000000000000_0000000U0000000
00000U00U0000000000000U0U000000000
00000U00U00000000000UUUUUUU0000000