........
..ccc...
.xxxxx..
.1...xc.
.1.S.xc.
.1...xc.
.xxxxx..
..ccc...
........