.............
...cccccc....
..xxxxxxxx...
.cx......x.2.
.cx....1.x...
.cx.3........
.cx....1.x...
.cx......x.2.
..xxxxxxxx...
...cccccc....
.............