vvvvvvvvv
vv00000vv
v0000000v
v0000000v
v0000000v
vv00000vv
vvvv0vvvv
vvv000vvv
vvv000vvv
vvvv0vvvv