............
...ccc......
..xxxxx.....
.cx111+..2..
.cx111+.....
.cx111+..2..
..xxxxx.....
...ccc......
............
......x++x..
..2..cx..xc.
.....cx.3xc.
..2...xxxx..
.......cc...
............