.........
.1.1.1...
.........
.x+xxx.1.
.x%%3x...
.xxxxx.1.
.........