***************************************************
***************************************************
****gGG*******eGG*******gGG*******bcc*******gGG****
**kgGghgG***eeReeeE***kgGghgG***cccxbbc***kgGghgG**
**ogggggg***Keeeeee***ogggggg***xccccXb***ogggggg**
**GggggGg***eeeReee***GggggGg***xbcccbx***GggggGg**
**GhggggG***GeeeeRe***GhggggG***bxbcXbc***GhggggG**
***gGgMG*****GeeeK*****gGgMG*****ccXxb*****gGgMG***
*****g****c****e****G****g****w****c****E****g*****
********bxcbc*****GGGMG*****Ss1:w*****GGRee********
********xccbx*****MhGGh*****sssos*****ERRRe********
********bbccc*****MGGGG*****woo1s*****eRRRe********
*********Xcb*******GMG*******:wo*******eeE*********
***************************************************
***************************************************
***************************************************
***************************************************
***************************************************
***************************************************
***************************************************
***************************************************
***************************************************
***************************************************
***************************************************
***************************************************
***************************************************
***************************************************
***************************************************
***************************************************
***************************************************
***************************************************
***************************************************
***************************************************
***************************************************
***************************************************
***************************************************
***************************************************
***************************************************
***************************************************
***************************************************
**********E*********w*********G*********c**********
********GGRee*****Ss1:w*****GGGMG*****bxcbc********
********ERRRe*****sssos*****MhGGh*****xccbx********
********eRRRe*****woo1s*****MGGGG*****bbccc********
*********eeE*******:wo*******GMG*******Xcb*********
****gGG*******bcc*******gGG*******eGG*******gGG****
**kgGghgG***cccxbbc***kgGghgG***eeReeeE***kgGghgG**
**ogggggg***xccccXb***ogggggg***Keeeeee***ogggggg**
**GggggGg***xbcccbx***GggggGg***eeeReee***GggggGg**
**GhggggG***bxbcXbc***GhggggG***GeeeeRe***GhggggG**
***gGgMG*****ccXxb*****gGgMG*****GeeeK*****gGgMG***
*****g*********c*********g*********e*********g*****
***************************************************
***************************************************