***************************************************
***************************************************
****0tt*******0T0*******0tt*******000*******0tt****
**k0t000t***0000000***k0t000t***000x000***k0t000t**
**0000000***K000000***0000000***x0000X0***0000000**
**t0000t0***0000000***t0000t0***x00000x***t0000t0**
**t00000t***0000000***t00000t***0x00X00***t00000t**
***0t00t*****0000K*****0t00t*****00Xx0*****0t00t***
*****0****0****0****T****0****w****0****0****0*****
********0x000*****T000T*****000:w*****T0000********
********x000x*****00000*****!0000*****00000********
********00000*****0T0TT*****w000!*****00000********
*********X00*******00T*******:w0*******000*********
***************************************************
***************************************************
***************************************************
***************************************************
***************************************************
***************************************************
***************************************************
***************************************************
***************************************************
***************************************************
***************************************************
***************************************************
***************************************************
***************************************************
***************************************************
***************************************************
***************************************************
***************************************************
***************************************************
***************************************************
***************************************************
***************************************************
***************************************************
***************************************************
***************************************************
***************************************************
***************************************************
**********0*********w*********T*********0**********
********T0000*****000:w*****T000T*****0x000********
********00000*****!0000*****00000*****x000x********
********00000*****w000!*****0T0TT*****00000********
*********000*******:w0*******00T*******X00*********
****0tt*******000*******0tt*******0T0*******0tt****
**k0t000t***000x000***k0t000t***0000000***k0t000t**
**0000000***x0000X0***0000000***K000000***0000000**
**t0000t0***x00000x***t0000t0***0000000***t0000t0**
**t00000t***0x00X00***t00000t***0000000***t00000t**
***0t00t*****00Xx0*****0t00t*****0000K*****0t00t***
*****0*********0*********0*********0*********0*****
***************************************************
***************************************************