%%00%%%%%%%00L0I000N00N000NN
0000L%%%%%L%00N000N00000000N
0%L00%0%00NLNL00L00000000000
%%0000NN0000NWWW0L0000000000
T0N0000%%00000WW00000000000N
%00N000LL00000L0000000000000
0NN000000000L000000000000000
%%000000L0000000000000000000
%TL00000000000N0000000000000
L000000000000000000000000000
0000000000000000000000000000
L0000N000000000N000000000000
LL0N00N000000000000000000000
00000000000000000000L000L0L0
000000000000000000000000000L
0L00000000W00000000000000L%%
00N00000LWWWN00000000000000%
0000000000WW000000000000000L
L00000000W0W0000000000L00000
0000000000000000000000000000
00L0000000000000000000000000
000000000000%000000000000L00
00000000000L00000000000000L0
00000000%00%0000000000000000
N00000L%%00000000000000000L0
00N00000%000000000000000%L%0
0000000%0L00000000000000%%%%
000000000000000000000L000%0%