    .......           
    .41.14.           
   ................   
 ...ww...wwwwwwwww..  
 ..ww............ww.. 
 ..w..5...cc...5..w.. 
..ww.....xxxx.....w.. 
.ww.....cx  xc....w.. 
.w....5.cx  xc.5..ww..
.w.......x++x......ww.
.w...cc........cc...w.
.w..xxxx......xxxx..w.
.w.cx  +......+  xc.w.
.w.cx  +......+  xc.w.
.w..xxxx......xxxx..w.
.w...cc........cc...w.
.ww......x++x.....www.
.www..5.cx%%xc.5.ww...
...w....cx%%xc...w... 
 ..w.....xxxx....w..  
  .ww.5...cc...5.w..  
  ..ww..........ww..  
   ..wwwwwwwwwwww..   
   ................   