     ........     
    ....cc....    
    ...xxxx...    
    ..cx..xc..    
 .....cx..xc..... 
.......x++x.......
...cc........cc...
..xxxx......xxxx..
.cx..+......+..xc.
.cx..+......+..xc.
..xxxx......xxxx..
...cc........cc...
.......x++x.......
 .....cx%%xc..... 
    ..cx%%xc..    
    ...xxxx...    
    ....cc....    
     ........     