...........
...1..1....
...........
..xx++xxx..
.cx....Txc.
.cx....4xc.
.cx...xxxc.
.cx.2.+%xc.
.cx...x%xc.
..xxxxxxx..
...ccccc...
...........