............
...ccc......
..xxxxx.....
.cx%%.+..1..
.cx%%2+.....
.cx%%.+..1..
..xxxxx.....
...ccc......
............