........
..x++x..
.cx..xc.
.cx.1xc.
..xxxx..
...cc...
........