............
...ccc......
..xxxxx.....
.cx222+..1..
.cx221+.....
.cx222+..1..
..xxxxx.....
...ccc......
............