9,9,3,2,2,2,2,2,2,2,2,2,2,2,2,2,2,2,2,2,2,2,3,9,3,3,
9,9,3,2,2,2,2,2,2,2,2,2,2,2,2,2,2,2,2,2,2,2,3,9,3,3,
9,9,9,3,2,2,2,2,2,2,2,2,2,2,2,2,2,2,2,2,2,2,3,9,3,3,
9,9,9,3,2,2,2,2,2,2,2,2,2,2,2,2,2,2,2,2,3,3,9,9,3,3,
3,3,3,9,2,2,2,2,2,2,3,3,3,2,2,2,2,2,3,3,9,9,3,3,2,2,
2,2,9,9,2,2,2,2,2,2,3,3,3,2,2,2,2,2,3,9,3,3,3,2,2,2,
2,2,9,3,3,2,3,2,3,3,3,3,3,3,3,2,2,3,3,9,3,3,2,2,2,2,
2,3,9,3,9,3,3,3,3,3,3,3,3,3,3,3,3,3,9,9,3,3,2,2,2,2,
2,2,3,9,3,9,9,3,3,3,3,3,3,3,3,3,9,9,3,3,2,2,2,2,2,2,
2,2,2,3,3,3,3,9,3,3,3,3,3,3,3,9,3,3,3,2,2,2,2,2,2,2,
2,2,2,3,3,3,3,3,3,3,3,3,3,3,3,3,3,3,2,2,2,2,2,2,2,2,
2,2,2,2,3,3,3,3,3,3,3,3,3,3,3,3,3,3,2,2,2,2,2,2,2,2,
2,2,2,2,3,3,3,3,3,3,3,3,3,3,3,3,3,3,2,2,2,2,2,2,2,2,
2,2,2,2,3,3,9,9,3,3,3,3,3,3,3,9,9,3,3,2,2,2,2,2,2,2,
2,2,3,3,9,9,3,3,3,3,3,3,3,3,3,3,3,9,9,3,2,2,2,2,2,2,
2,2,3,3,9,3,3,3,3,3,3,9,3,3,3,3,3,3,9,3,3,2,2,2,2,2,
3,3,9,9,3,3,2,3,3,3,3,9,3,3,3,3,3,3,9,3,3,3,2,2,2,2,
3,3,9,3,2,2,2,2,2,3,3,9,9,3,3,3,2,3,3,9,3,3,3,2,2,2,
9,9,3,3,2,2,2,2,2,2,3,3,9,3,3,2,2,3,3,9,9,3,3,2,2,2,
3,3,2,2,2,2,2,2,2,2,3,3,9,3,3,2,2,2,3,3,9,3,3,3,3,3,
3,3,2,2,2,2,2,2,2,2,3,3,9,3,3,2,2,2,2,3,3,9,9,9,9,9,
2,2,2,2,2,2,2,2,2,2,2,3,3,9,3,2,2,2,2,2,2,3,3,3,3,3,
2,2,2,2,2,2,2,2,2,2,2,3,3,9,9,2,2,2,2,2,2,2,2,2,2,2,
2,2,2,2,2,2,2,2,2,2,2,2,2,3,9,3,2,2,2,2,2,2,2,2,2,2,
2,2,2,2,2,2,2,2,2,2,2,2,2,3,9,3,2,2,2,2,2,2,2,2,2,2,
2,2,2,2,2,2,2,2,2,2,2,2,2,3,9,3,2,2,2,2,2,2,2,2,2,2,